NO ./files/wall_north.xpm
SO ./files/wall_south.xpm
WE ./files/wall_west.xpm
EA ./files/wall_east.xpm

F 185,164,137
C 143,197,220

        1111111111111111111111111
        1000000000110000000000001
        101100000111000011111100111
        10010000000000001    100001
11111111101100000111000011111100111
100000000011000001110111111111111
11110111111111011100000010001
11110111111111011101010000001
11000000110101011100000000001
10000000000000001100000010001
10000000E00000000001010010001
1100000111010101111101111000111
11110111 1110101 101111010001
11111111 1111111 111111111111
